...........c.
..@.cc.......
.c...c.ccc.c.
.c.....c.....
.cc..c.c.....
...c.c.c..c..
...c...c..ccc
c..c.....c..c
..c..ccc...#.
.............